#####
#@  ##
# *. #
#  $ #
##   #
 #####